root: randomises
daemon: debauchers
bin: archgenethliacs
sys: insuperableness
sync: irrecognizable
games: octogenarian
man: isographs
lp: nonstaples
mail: decads
news: laundry
uucp: accourage
proxy: anglifying
www-data: tranquilizingly
backup: doctorands
list: propinquity
irc: postulancies
gnats: appending
nobody: oligochaete
systemd-network: uncourteous
systemd-resolve: somewhen
syslog: reciprocate
messagebus: effortful
_apt: twixt
uuidd: ostraceous
avahi-autoipd: dolphinfishes
usbmux: strobilated
dnsmasq: inamorato
rtkit: explosive
cups-pk-helper: oceanfronts
speech-dispatcher: crossbanded
whoopsie: aforethoughts
kernoops: polyonymous
saned: wrappering
pulse: formably
avahi: reprobatively
colord: hygrodeik
hplip: chirognomy
geoclue: cockbill
gnome-initial-setup: apomict
gdm: radicule
mathcsadmin: lanker
sshd: chondroskeleton
mtie: slumbered
statd: disseised
dstephans: ruthlessnesses
awb: kyangs
x2gouser: eschatologist
x2goprint: articulating
abarrios: bias
abdih2: gradatim
abelsonk: chinawares
adachis: checkmark
adalal: silicium
adamsc2: muensters
addaberkanem: vealier
adlert2: adjourning
admadjajaa: deploration
aestill: interpermeate
aguilarj: reprehensive
aguirree: hookworms
ahlgrenk2: mayday
ahmeds3: clepes
ahrensd: flick
airoldie: sylis
akindonaf: areolation
akiyamaa: malonate
aknodell: calotype
akyianua: outsmiling
alappath: cringings
albrightk: roentgenologic
alexanderd2: railman
alexanderj: prisers
alia: dustlike
allabens: decentres
allenm2: clutch
allgoodm: undertrump
aloy: precedential
alsakerj: intrencher
alsheikha: unceasingness
alsheikhc: zestless
altaweelw: centralizer
alvarezj: irksomenesses
alvarezm3: gammadion
alvarezruizc: metaxylem
amagaik: falters
amlande: warrey
amoltcha: poem
amoulana: glorify
andersonb: normalise
andersond2: baetyls
andersonm2: relock
andersons: tuboplasties
andrewsa: ozonize
angevinej: diuretics
aokib: gavials
apchikka: outthought
apoppick: ripened
arafferty: atomizer
arbogaste: reexportation
arbogasti: actinias
arevaloi: vaticinations
aroraj: simplification
aroras: vocalise
aroras2: unitises
arovasa: implacableness
ashurstd: primines
asifs: pranckes
assafn: double
aswoboda: oncogene
atont: lecithinases
augustind: arterialisation
avilal: aeroballistics
awady: overattentions
ayarsj: bylive
babajidec: thermosiphons
babbitk: sabellas
babineta: swops
bachulisj: pedder
baern: undecks
bahnm2: queasiness
bailardj: fibromyalgia
ballen: onomatopoeses
ballingerl: inventory
banuelosg: naivest
baoa: unrooting
barnettb: tsaritza
barnetto: prerock
barons2: braindead
bartkovichj: juncuses
bartont: outsweeten
barzele: misfaring
basavareddir: licentious
bascomi: recommended
baskaufj: prelateship
bassonm: abalone
bastimarr: pacificating
batjargalb: chowchows
battista: cavetti
battlew: illegible
baumgartej: diebs
bauschw: acrylonitrile
baxtera: rattener
bboling: tays
bduffy: systaltic
becerraa: plentiful
beckerr2: kindreds
becklerj: patellectomy
beddoww: lilliput
beebya: webbed
befekaduh: erasures
beimersa: izar
bellc2: underslung
belli: nonresistance
belln: symbiotic
bellonie: objurations
bellovind: scorchings
belzert: persistences
benklern: pinpoint
benoya: epoxidize
bensena: disenchanted
bensenh: quits
bensone: trialists
bergerj2: passatas
bergert: wherenesses
bergk2: imparled
berkowitza: defi
berlagej: singlings
berlerm: acquiring
bernb: surgical
bettinm: irrepleviable
betzg: interruptors
beyenee: policed
bhanijkasemv: weaseller
biddulphe: inharmony
bierleya: obsigned
bigelowa: prewiring
bigirimanaa: rotavirus
bigorniaj: chiffon
bindern: cyprids
binsc: transumes
binzaka: sauries
birdsongs: discipleships
bkopack: lukewarmths
blackette: lithoid
blairs2: blobbier
blairsmitha: earlship
blanchfieldp: lionfish
blarocqu: selvaging
blocka: xiphosuran
blockr: cyclopropanes
bloodworthe: arseniate
blumenthala: sepads
bobob: pitcherfuls
bodanskys: expatiates
boehnkeb: dropstone
boermas: autobus
boerow: roominess
boitnottj: unrepulsable
bommaritom: soliped
borgmannm: incompletions
borgmanns: gelatinoids
bornsteinm: voidable
boroughsc: etapes
bosshadit: scull
bottigerd: clivers
bouzaa: kamikazes
bovornvirakitc: sabbatised
bowersj2: labialize
bowlanda: doomwatcher
boydr2: packhorse
boyere: unprizable
boyuml: xenolith
bozicevicha: sunscalds
bradym2: disfurnishing
branskyj: allocheirias
braulickj: unfrequently
braunj: whiffletree
bremerw: sialids
brewsterb: undertane
bridgemana: rollerbladers
brimn: boogieing
brindleg: dryable
brinkj: haplonts
broadbentc: hyperexcitable
brodnaxa: arachises
brodyc: parvenues
bromana: compressibility
brookmang: hobnobbed
brooksa3: interestingness
brookskahnh: paraphrastic
brownc2: tramper
browni: kirpan
brownj4: shoaling
brownlawa: pyrolusite
brownt3: chirring
brownz2: rowdedows
bruelle: photometers
bruihlera: redefining
brusilows: faddy
bryantm2: baur
buckk: planchets
buffettz: nidificated
buhmans: fixatives
buik: sib
bullockm: unrecounted
bunajindaa: toponymies
busche: effusiometer
bushj: paddy
bushmanc: karstic
busisd: phrenesis
butterfieldp: crusado
buyuccanm: lexicography
byrnel: turpentiny
byund: ignite
byunj: unoxidized
caballeron: spoofings
caglieroe: midspace
caie: kouros
caiw: micrometeoroids
caldero: brose
calicdand: comarbs
camarilloc: craniometry
camerona2: renatured
campanac: tabbinets
campl: blacker
camposd: comicalness
cannelli: jobless
caplowh: launchpads
cappb: pipetting
caradimitropouloj: lead
cardenasa: misate
cardonao: veinule
cardozaj: logion
carlsenm: stairstep
carlsone2: phlegms
carothersl: cognitivities
carranzas: spiffinesses
carreteroc: peachily
cartwrightb: outspokenness
cartyc: sliver
caseyf: quiltings
casmeym: yachter
castanedaj: reusable
cauthorns: additively
cavanc: untranslatable
cburden: eerinesses
ccollins3: femmiest
cfarhart: fivepin
cfortin: bromhidrosis
cfureslo: kojis
chaed: daines
chaffeeb: interserted
chai: wolfskins
chammamh: seaning
chana2: oscillative
changa2: brayer
changa3: basophile
changt: adversariness
chanj3: cracker
chaob: platinocyanic
chapmanh: dibblers
chappellg: palmatipartite
chardy: cankerednesses
charltoni: clinkers
chaul: degrade
chavezk: synalepha
cheblis: wolver
chekhovoiv: retempered
chenc4: nittier
chene2: conspicuously
chene3: somaesthetic
chenga3: zastruga
chenge: explainable
chenj3: hearthstones
chenk: monochlamydeous
chenk4: splintwood
chenr6: posits
chens4: resolutes
chens5: noctambulisms
chent3: dahabiah
chent4: curtsies
chertoffa: antirusts
cheryb: night
chesivoire: metronomically
cheslerb: culminations
chhuganis: forerunning
chill: promissorily
chingl: nominal
choa: tendrilled
choie2: saviors
choir: intreat
choiy2: cotinga
choyc2: wincing
christiansene: clamoured
christopho: motorbicycles
chuc: environs
chud: morbid
chuens: thereinafter
chundrus: unremovable
chungd: overbrows
chunge: gardenless
ckohnen: amtman
claphamc: haftaroth
clarka2: precognitions
clarkb3: photomontages
claussm: khansamahs
clawsoni: pilferages
claybakers: kazatzkas
clayo: pistolet
clellandk: admired
clipperd: remanning
cochrane: nepheline
cochranl: leres
coffing: earmarking
cohena2: faintness
cohenl2: underplots
cohenn2: strapontin
colcold: sleeve
coletm: precensor
collinsn: venom
collinss2: abscinding
conatia: chally
conev: whelped
connelln: reconstructed
connj: antonymous
cookes2: gests
cookj3: angelology
cooneym2: securitans
cordovai: mondains
corletta: trod
cortesv: quicksteps
costelloc: itch
covingtond: continuatively
cowane: haves
coynej: gaumless
craigj2: twaddler
crawmerj: diphthongize
crowni: arrowing
cturnageb: uredinium
cuid: sneery
cuil: assurgency
culottaj: trone
culverwellr: explicit
cunninghamf: flypasts
curtisa: clearings
cyandell: creamlike
czimmerm: resisters
dacunham: latinized
daib: arcatures
daii: sabeing
dalberg: homogenies
dalessioq: smalti
daleyj: froes
dallugej: weazens
dalmeidad: siwashes
dambergottm: biotron
danielsonk: incliner
danksm: palilalia
daot2: auf
dappleya: hoars
darwishs: hailiest
dasilvab: recarrying
dass: misprizing
davide: apostille
davilav: fancifulnesses
daviso: echopraxias
davisonm: prawns
dawsonr2: cheesecutters
deanj2: telescreen
debenedettig: barmitsvahs
dehaans: draftinesses
deitzman: studworks
deleonc: licitnesses
delgadoa: lamedh
delgadoe: umbracula
delgadoj: attractances
delrosariot: diatonicisms
demelolemosb: reimbursing
demetriadesl: naphthylamines
dencklaz: hahas
dengy: turophiles
dennen: bucolics
destah: particleboard
devgunk: bacillar
deweaverb: colleague
dewyngaerts: corantoes
dfoxgrov: smouldering
dgroll: pompier
dgupta: specializes
dhaunspe: clockings
diallod: ghazis
diamondl: multilingualism
diazg: godslot
diazgarciaj: reduce
dierse: civilists
digavallik: sightsaw
diiannic: tweets
diiuliol: mudirias
dillmann: whimsily
dinardoz: undercool
dkohen: suppletory
dln: sidings
dmarshall: jointednesses
dmusicant: hectographed
dominguezb: fastigium
dominguezj: glamourpuss
donahuea2: posoles
donahuel: decerebrated
donnellym: abscisins
donnellyp: glands
donohoc: pagehoods
dorchenk: newed
dpearsal: neoterised
drakedunnc: augmentatives
dregerm: aeromotors
drennana: pleasuring
drivere: roadsman
dubinskye: outparts
dudarovw: tallied
duh2: thieved
dujsikovaa: lentigines
duncanm2: restacking
duplessisk: scurs
durnbaughe: drinkables
dwalser: draughtboards
ealexander: seedlips
eatono: isogons
eegge: charpies
eglintonh: disapparelling
ehresmannp: animadversions
ehrhardta: parchmentizing
ehrhardtk: multipartite
ehrlichc: tenancies
eichelt: ventouse
eidmannt: gumshoes
eisend: semibreves
eislunds: diminishable
ekanayakej: siffleur
ellefsone: lifes
ellisa3: sneakinesses
emckinse: undersupply
emlene: unconfederated
emlent: typologic
emmonsm: favouredness
emmonss: baryta
engela2: electrothermy
engelk2: rhapsodising
enriquezd: shoder
erichc: shmoes
ericksonk: enhypostatized
ericksonw: codist
escosteguyl: shiels
espinozad: topmast
evansg: crazes
fairchildm: succumbed
fanp: oversubtle
fariasa: deviationism
farnsworthh: outvillained
farrelle: betaine
farrl: fauna
farwellg: cassene
fbhuiyan: underprising
fcontreras: stegodons
feldermanj: puggings
felknork2: forfended
fengb: aspects
ferrere: outfalls
ferrerl: bumsuckings
fickl: crispnesses
fieldl2: periostitises
figueroav: synthesizes
finesr: antinucleons
finew: centime
finneye: filmcards
finstuenk: tridents
finstuens: amphibrach
fioccoj: redemptional
fisherj2: devotements
fisherk2: beastily
fitcha2: rejuvenized
fitchs: anadem
fitzhughn: micrograms
fjaramil: outbreed
flaksbergc: undershirts
flanaganr: smokejacks
fleishhackerj: tricar
flemingw2: woodenheads
fletcherw: ront
flignorj: nincums
flinnc: hellenised
floresg: irones
floress: nonruling
floydt: phlebotomist
fonderj: cuprammoniums
fordn: reversional
fordr2: abjoints
fortsone: inalterably
fosterk2: faeries
foxr2: bromic
fraleyj: newsagents
franchotl: biyearly
francoj: um
francos: subgenus
frankla: toweling
franklp: gallonage
franzene: woozinesses
fraserminesk: dentists
freedmanm: yities
freelandt: swainishnesses
freemanc2: friedcakes
friedena: pollutednesses
friesenb: semierect
friesenh: shrimpiest
frohlichh: aspros
frym: arrowworms
fultone: shroomers
furlongj: remobilises
furtadob: voulge
gaborm: funniness
gagnonp: behavioural
galambosd: oftennesses
gallantj: canisterised
gallegoj: panophobias
gallina2: sdeining
ganjams: juxtaposes
gaoa: lardalites
garciac3: denizened
garciad2: intranets
garciar2: airboats
gardnerc2: teaseled
gardnerj2: alfaquins
garnera2: terrellas
gassele: loper
gatesj: hypocrisies
gaughanc: doctrinarians
gautiere: forefeeling
geistm: intraocular
georgeb: deerlike
gerbinoa: kolacky
gershmanw: queenships
gibsonm2: gophers
gilbertk: aeneous
gilbertr2: dacked
gillardn: classicizes
gillenf: renograms
givensn: nephroblastoma
gjertsonm: electrotyped
gladishd: resecured
gleasonw: anthologizers
glennb2: potbound
glosss: nother
gnelson: nonguilts
goenkam: taffetases
gohelc: purgatively
goldberge: openmouthedly
goldbergm: ceaze
goldbergm2: cicatricula
goldenberga: meridionally
goldenbergz: ovary
goldhaberz: polyphones
gonzalezs: reoccupying
goodmans2: sparse
gormallyc: fortunes
gormana: mouching
gormane2: tigs
gorram: bodyshell
goulda: bialy
gracej2: gism
greengos: netted
greenj2: crickets
greenleee: parures
greenm3: outthieve
greenoj: pectens
griers: intuitionist
griffina2: underfeeding
grindej: cissings
groganr: althorn
groosj: illusion
grossere: quivering
grossmank: subraces
grovea: waysides
guangc: upfilled
guangc2: shikari
gudgelr: phonemicises
gueyec: skeg
gullicksonp: turmeric
guoa: luthier
guox: harbourless
guv: scants
guzmanc: luminescent
gvrtis: undertake
hadjiyanise: antismokers
hafnerb: subvertical
hagarm: loach
hagstromp: pigeonhole
hagueg2: demonologic
hahnj2: recurrence
haileabd: pareses
hairstonk: counter
halladaya: funder
hallc2: approve
hallc3: eulachans
halle2: trudger
hallk2: strives
hamiltons: limeades
hanchetg: escrows
hannigank: astonish
hansene2: uneasier
hanshawf: piemen
hansonc2: fogydom
hansone2: corrosivenesses
hansonj2: nithered
hansonk2: revealable
hansonn2: necessaries
hanw: rearisen
harmonb: endoscope
harrisn2: zwitterionic
harrisn4: neural
harrisona: welking
hartzella: misseem
haugk2: voodooistic
hauserj: enterchaunge
hawkesk: feminineness
hawkinsm: partings
hawkinsn2: formfitting
hawsj: glow
hayesrichn: squiralties
hazeng: oses
hedgecockn: commutate
heilbronnerr: bubblegums
heinzelj: handicrafts
helgerude: quannets
hembrei: contractions
hensonm: barker
herberss: funkhole
hernandezc2: chunders
hernandezo: trendier
herrc: references
herreraf: loveliest
hershewee: feudary
hes2: tannates
hettlea: depressurises
heuchertc: bringdown
heuchertk: anteversions
hev: overbig
hew: resolubilities
heymane: wais
hhuergo: pyelitis
hicker: fubsiest
hikens: involucrum
hikinok: resters
hiltym: elopes
hintonp: lithifying
hinzmanna: retrophilias
hirshbergs: zootechnies
hirshmana: invades
hliuspen: hybristic
hmiller: metrical
hoanga: respades
hodges2: suites
hoffmanj2: bioinformatics
hoffmanp2: parboiling
hofmannm: meridians
hoj2: mereological
holcombh: barrios
hollowayl: diriges
holta: dorring
hom: crenelations
honga: surfactants
hopek: embayld
horia: ur
horiuchih: kapellmeisters
horwitzb: distichous
houcko: myomas
hrubya: inulase
huad: prokes
huanga2: amidogen
huangv2: libriform
hudsonb: therbligs
hughesa2: unfact
hughest2: interdines
huh: quotients
huhe: bloquiste
hultgrenk: spurrer
hummeln: frigate
huntm2: protractedness
hurtubisel: impresari
hussaink: sectorials
hussains: smouching
hutchinsonm: orcas
huynht: lateralling
ibtesumm: webster
icklera: skirmish
icklerj: hoodwink
idrogox: decarburise
iftikharw: archaicism
imaik: nasality
inkelase: shouter
intasinp: complicitous
ironsw: ecoterrorisms
irwinp: poppets
isaacsa: dynasties
isaacsj3: xerophily
isaacsonj: eilding
isbelln: miraculous
ismaile: chokeys
its: molybdenous
jabbarpourc: outflashed
jacksona3: empts
jacksonk3: semipalmation
jacobsona: unspared
jamah: biofoulers
jamesc2: nosebleedings
jamy: monohydrated
jansenc: coaitas
jbrioso: invalidator
jbryce: luncheonettes
jbushey: embusies
jcernaba: naturae
jcwillis: perseveringly
jdavis: pullbacks
jdecker: bellarmines
jehngm: unpretendingly
jellinge: perambulator
jensone2: displeasances
jewelerb: phonation
jgoldfea: sketchiness
jhallen: gynies
jhoelzel: concretenesses
jiangz: arterialises
jimenezf: yob
jinj: yuan
jinleeh: quarterlights
johannz: cryptarithm
johnsona5: misdiagnosis
johnsonb5: furriner
johnsonb6: chuddy
johnsonc3: petunias
johnsond2: patrols
johnsonj4: inessives
johnsonj5: subphases
johnsonl2: miscomputation
johnsonp4: gazements
johnsons2: including
johnsont2: comstocker
johnsont4: blears
johnsonz2: urnal
jondich: moose
jonesc2: turnover
jonese4: stokehold
jonesj2: serradella
joness3: turcopoles
joness4: anemograph
joness5: reasonably
jorlingp: bewrap
josowitzr: creole
journellm: afflations
jpierret: biocenologies
jscannell: spamming
jschicker: referrible
jstrand: malingered
jtymoczk: piednesses
judget: transportings
julies: scintillating
jurkovichm: antivitamin
jurotichm: prolepses
jussilak: bellpushes
jweisber: bioscience
kaegig: tester
kaitanym: lepidolites
kalmusm: knotweed
kammannm: denote
kandelj2: succourers
kange: conservatising
kannelj: arbelests
karln: dispurvey
karpe: domineering
kastnera: observationally
katarie: clerisy
kaumeheiwam: comeliness
kaushikkarn: volumetrical
kayem: pyritiferous
kchapman: fineers
keaneg: washroom
keeleyh: bacca
keelp2: laggens
keena: impingements
keithahnh2: ericoid
kellyc2: operatics
kellyk2: dilations
kellyw2: germain
kemptond: estruses
kendallb: erotology
kenneyj: psilomelane
kernallelyc: superterranean
kernerm: browny
kerwinm: discomycetous
kessenichs: nukes
kgalotti: remens
khake: humoralist
khayatn: consolating
kiernanl: midships
kima3: antepenult
kimb2: yahoos
kimballk2: flyless
kimberks: dithering
kimd3: bushless
kimj5: spay
kimleed: spawnings
kimmellc: displenishments
kims2: wrast
kimzeyo: immoralisms
kingn2: miscarriages
kirala: persicos
kirkhoper: ferventest
kirklandk: dimps
kisickic: teils
kisselr: silicula
kitchenc: dholls
klaitsa: septennate
klanderudj: follicle
kleberd: bushmeat
kleina4: tastinesses
kleini: snipelike
klineb2: recross
klinesharpec: downplay
klosa: frostbitings
knezevicm: equibalanced
knightena: replicases
knights3: punditries
knospew2: tartar
knowlesr: trouncer
knudsonm2: undermen
knutsene: phratries
knutsonl2: scripturally
koellingh: aspartames
kohlmanc: cutwork
koppelb: colcothar
korobovaj: underproduction
koroseie: hanks
korpim: rifles
kosekm2: peptids
kotlera: strumpet
kotulae: watchets
kraabels: tumultuate
krakaurd: crossbar
krala: dissolutive
krantzk: airtightness
kroegers: outwith
kronickc: accuratenesses
kroppa: gopaks
ksmith: tors
kstclair: tunics
kstrode: administrate
kucicha: uproaring
kuhsm: burghers
kulstadz: surrenderers
kumars: limmers
kunsangt: cross
kuritar: scramblingly
kyhlm: spleenfully
kyrysyuks: juridical
lachmanm: cycloses
laffayet: sinciput
laij: osteodermous
laliberteb: untruthfully
lamj: wrinkling
lamn: unconstrainable
lanierd: misalleging
lanierk: outmeasures
lankfordr: irresolvability
laschc: syringeal
lasleyc: garbologists
lasterk: embraces
laubo: kell
laveys: impropriate
lburdell: fluidities
lchihara: corelate
leakek: puppydom
leb: splenius
leblanct: multimember
lederere: paneer
ledskyi: repasture
leeb4: holk
leec2: censored
leee2: hispidity
leeg3: palolos
leek2: caid
lees3: missent
lees4: nonfinite
lefebvres: curtilage
lefkowitze: suers
lehmane: salvo
lehmanw: bedspread
leisherz: punny
leithere: aplanatically
leitza: tracheates
lekkis: afreet
lellison: hypocorism
lemastere: dogsledded
leonarda: uncooperative
leonegettens: tironic
leppinkc: ayre
leslieg: expires
leuchtenbergerg: tapaculos
lewisd2: eiking
lewisj2: fictitiousness
lewisz: soliloquised
lia2: chetnik
lia3: supermicro
liangb: accrews
liangj2: oughlying
liaog: recceing
lichto: dobsons
lie2: nondeforming
lieberkotzo: seriphs
liebermane: disarmer
liesmanj: ethnarchy
lik3: pick
lil3: myrioscope
lima2: knout
limz: title
lina: means
linb: preadapts
lindgrena: tubulously
lindholmj: sods
link2: bowats
linki: pre
linl: demonization
liphartc: pelmanisms
liq2: opacifier
lir3: bodeguero
littleg2: apotropous
littone: unperceptive
liud4: sideswipe
liue2: gramary
liuf: valuationally
liuh: conversely
liuj3: pipsqueaks
liuq: usurpations
liur6: dignity
liur7: charcuteries
lius3: trotlines
liut3: winier
liuy2: atoms
liuy3: domatium
liw: whillywhaws
liw4: chitosans
liz2: catalogized
lkolek: newborns
lobetg: thulite
loea: forhooied
loesper: ekpweles
loewa: ostreophages
lofquista: conjurators
longe: perichaetium
lopezn: harmonist
lorenzf: wanted
louisa: daffodil
lowej2: slipsheeting
lowere: flannens
lowryb: cruelly
lowryn: decigramme
loye: alfilarias
luapinedac: behavioral
luedkeh: pejorating
luljakj: ecclesiologist
luoj2: lamellation
luot: dispeace
luoy2: pollucites
lutherj: reciprocator
luy: catabolised
lyang3: unloveable
lynchb: myxoedema
lynchm2: syllabized
lynchy: socdolager
macarthurn: ovulate
macdonells: repairmen
mackinj2: accloyed
madsenr: blowziest
magerl: excellent
mahmoods: mutinying
maierj: oxacillins
maitlandl: haurient
majumdarm: nonwhites
makatsariaa: baps
makia2: kikuyus
malik: legumin
mallyas: outwriting
maltbye: browless
mamantove: oligodendrocyte
maneenoij: disinvestment
mangenat: revalued
manivelm: kobang
marceln: asphyxiate
margolisj: ninons
marinoa: benightednesses
markerm: piquance
marlinj: cofeature
marquetteg: defusing
marquezd: mararis
marshn2: strabometer
marshs2: tertiary
martensj: perpetuated
martinezs: debridements
masakin: overselling
masakuraa: breasting
maticanr: varletries
mauricen: sunbathings
maw: hypoplastra
maxwelli: biodynamic
mayad: secularity
mayerm2: propaging
mayfieldc: myasthenias
maymudess: legionaries
mbailey: concertantes
mcass: padauk
mccarronl: listerial
mccarthys: counterattacked
mccartneyr: plasmasol
mccayi: antiaircrafts
mcclintockl: ajowans
mcclurgm: deobstruents
mcconnellm: duchessed
mccoyc2: dynamos
mccraryz: cicinnuses
mccreal: sincereness
mccreap2: marlinspike
mcdonnellp: externally
mcferrink: skikjoring
mcgregorr: passemented
mcguckenk: substructure
mcintoshr: digladiations
mckelveyb: propagandistic
mcmillanr: lace
mcnameec: foreboder
mcohen: unpersuaded
mctaggartc: hospitia
mcveighq: wristbands
mdecker: skerricks
meesenat: undrained
mehtat: greaten
meia2: refreezes
meiklec: juke
mellinb: apotheosized
mendeza: compulsivities
mendiolam: compresses
mendozav: extralegal
mensendiekh: boldface
mere: overflourishes
mertzn2: exhalant
metzf: pinkeyes
meyera2: denseness
meyere2: suffumigated
mhansell: jibbs
michiia: pilot
mihiram: gelate
mikulskit: mesquits
miless: migraineurs
milliganc: bearwoods
millikene: unfool
minj: presidentess
minj2: defenseless
minoe: exuls
misplonj: laryngoscopy
misraa: supremities
mitchelle: eyalet
mitchellk: inflammables
mitchellm: hyoidal
miyagik: nomologically
miyazaway: transposition
mjflynn: mayster
mkaga: genotype
mkanazaw: palatalisation
mkruseme: map
mlupp: oneness
mohamedh2: hyperalgesia
mohamedn: stockinesses
mohameds: incentivise
mohanm: rhomboids
monahans: spidery
montgomeryr: calyculate
moorek2: gasp
moores3: interwove
moralesc: quindecennials
moralesc2: tinnie
moralesm2: abstruse
moranj2: sharkskin
morel: cryophytes
morrisa3: greeting
morrism3: disimprisoning
morrisseya: lolly
morscheckc: oxycephaly
mosborga: sextillionth
moseleys: spininess
mothersheads: environment
mourningl: stemmas
moyb: reassailing
mrand: pelage
msehgal: gastronomical
mua: unwieldliness
muellerl2: commuted
muhlheimr: undedicated
mukherjia: zarapes
mukherjia2: urinalyses
muleyy: stubbornly
mullanj2: processes
mungerk: emotionalism
munkr: periboli
munn: ghostwrites
munyeshyakam: metrics
murphya2: lioncel
murphyh2: lichenologists
murphym2: sepaline
muschlerl: revisory
mvanderw: doodler
myerss2: homaged
nabaris: scintillons
nachreinerl: cleanskin
naganumaj: nonfictional
nagaokay: starwort
nahleyc: plenishers
naj: lieve
nakahiraa: grillrooms
nakamotos: metaplastic
nakasakaa: denis
nancea: blepharitic
nassg: cordiality
navarrob: discumbers
navarroj: multiservice
navratilj: pyrometer
nawm: youthful
neidharte: uveitises
neimana: schnauzer
nelsonb2: electronicas
nelsons2: mitosis
neumannl: ascendent
newellr: wuzzling
newmanl: flaccidnesses
newmanl2: interrogational
newmant2: honourless
newshams: screeders
ngaik: totalizers
ngot: preappoints
ngrawe: currier
nguyenc: glassmaker
nguyend: narrows
nguyenq2: begetting
nicholasp: rousts
nika: ungotten
nlutsky: gliffs
noisecatz: bemoaners
nootenboomk: olycook
northj: pullup
norwoodl: dons
nossw: ferula
nowakk: wireworkings
ntomonar: traditionality
nullg: watchet
nybladel: stotins
nykampc: anisotropically
nystromk: batterie
obergj: mesaticephalies
obiesel: gophering
odak: precludes
odiernog: wainscotings
odoome: liefs
odubayoj: typecasting
oettingerj: disseize
offmane: superexpensive
ogilviej: octadic
ogradyf: secretory
oguhc: torsibilities
ogutum: illiberality
ohaship: unsparing
ohrstroma: naturalizations
okadak2: mealing
olandert: landsman
oldhamm2: hookworms
olsendufoure: ambulation
olsenf: porting
olsonc3: outbacks
olsone2: macaws
olsoni: wastrie
omoiyamuo: madzoons
onomiyan: gabbroitic
onyeanuj: licensers
ooiw: areal
orepoorjays: beakier
orlinz: misspeaks
orozcoa: gummata
osham: hypsophyll
otsukae: toughen
ouweleenf: bollockses
owensm: modalist
paaschek: fellation
padillac3: guidon
pageb2: intriguante
painem2: gamelans
paka: diazinons
pakl: fissioning
palenovad: gustie
palmbacha: overcrowing
paltrowe: porogamy
pandelakisn: grandsire
pandeyk: tenderize
pangburnw: copresent
panm: mediaevalist
papajohna: gauped
paradac: undiverting
parkers2: sulphurs
parrotth: ecstasizes
parsonsa2: freedwomen
parsonsk2: needcessity
partidaa: kaifs
pasleyo: encash
passinok: faustian
pattersont: sleekers
paulsonl: stigmasterol
pearsong2: heard
pearsonh: vaginulae
pedersena: zoarium
peeblesa: senses
pelletierz: dyscalculias
pellizzerm: singsongy
pengg: kyaks
penprasea: based
perryb: didactylisms
petersl: biocide
petersond: amu
pfeldman: grizzle
phamm: fleshworm
pharoz: repryved
phelanc: agistments
phelpsr2: mouldwarps
phungk: implants
pic: coassist
pickense: furol
pihlajaa: hyphening
pikej: gramophonist
pinaa: latrocinies
pinkneyn: superrefine
pinsonk: balkanised
piperh: wooding
plackie: canthooks
plaschl: fuchsine
poeschlaa: withholding
pohlmanr: trampolinings
polancoa: piquing
pollardc: pochards
polleym: pleiotropic
pompern: toecap
poolosz: colds
popem: protestors
portisj: retiringly
posh2: platier
posnerc: abusively
potterm: relationships
poulseni: respondence
powellm2: diplomat
powello: sequel
powersw: bronchoscopies
pozzii: ledger
preet: blackleg
preissb: aulnagers
prenticea: doggo
presserc: spumous
prichards: concretists
priestm2: tabrets
prinsm: paludamenta
profittl: physically
pseneviratne: euthyroids
purduma: pinies
puzakm: refitted
qia: chums
qiangt: stoutened
qine: flaffed
qins: effendis
qium: storyboards
quasts: impendent
quattruccii: emules
quaylep: hyperidrosis
quigleyt: talmudisms
quintanar: curari
quinterod: hemicellulose
rabagoa: tractile
raderd: staffman
radinskyj: vaporosities
rafkina: hules
rahadiana: spreadsheet
raiyanir: scrump
raka: brasiers
ralaimo: teasers
ramann: companionable
ramirezj2: barrat
ramirezl: airbases
ramirezt: connumerations
ramosa2: rigg
ramosj: graithed
rankini: hypersensual
raon: chieftainesses
rapaczs: crucian
rasmussenm: intersperse
rawlesa: superheroes
rayl2: substyle
rbarkmei: myxamoeba
rdobrow: lactalbumins
readyp: nonoxidizing
redmonds2: suffices
reecel: yestermorn
reedwestonm: kiddywinks
reevesn: bantling
reichp: theriomorphosis
reidn: milliners
reidt2: cohibitive
reinhardtc: megadeals
reisenfelda: overestimating
rekemy: laborites
relveton: panzers
renz: dentifrice
rewc: inexistent
reynagag: holophytism
reynaldoi: digitules
rfjones: downmost
rgoerwit: seismonasties
rhyneers: circumcentre
ricee2: whetting
richarte: sambal
richierip: gastraea
richterb: reestiest
ricos: antisepticizes
ricos2: inexpugnably
rigneyk: cuttoes
rileyo: lapin
ringrosec: emblics
riquelmev: defibrillate
rittera: phonate
rittmanh: nipper
riverab: veratrine
riverar: aquafarming
rivesb: dinnerless
rjackson: communitarian
rkeiser: paradoses
rnau: pyrogenic
robertsa2: desining
robinsonj2: retrorocket
robinsonl: disorganizer
rockd: overfamiliarity
rodriguezn: refine
roethlera: sovietize
rogerss: charmed
roizind: amoxycillin
rojasr: disorganiser
rojeke: monogeneses
rolandc: radicalized
romanenkos: misgoverns
romanovaa: arcologies
romans2: ritzy
rosenbergh: elytriform
rosenbergm: tantalous
rosenbergs: supracostal
rosenc: rede
rosenfeldk: monogamic
rosenfeldm: reawaking
rosenfieldn: yarmulka
rosenn: cashpoint
rossa2: slivowitzes
rosss2: swang
rotix: unimprisoned
rourkee: lehrs
rousseauh: tenebrae
rowleyn: curarizing
roya: fossa
roym2: prehended
rpetrick: rousement
rthompson: slavers
ruanc: craver
ruasanchezf: shaftings
rubind: disencumber
rubing2: bemurmured
rubinot: reapparels
rubinpopea: gainlier
rughanik: uniseptate
rweiner: erraticisms
ryanb: burnooses
rybarczykj: converse
sachse: knowings
safdarh: circulated
sagalg: entreating
saida: encrypt
saintils: hungriness
sainzn: oxidizing
sakimoto: imprimatur
saksenac: monochromists
saksoni: skyclad
salazarv: jarl
saldiviaf: thirteens
samselt: malaria
sandersc2: copple
sanghia: obtainable
sangvongp: vetchier
santosb: overseeing
sassl: pepsin
satisha: holyday
sauera: demoniacism
sauerbergn: drouking
savagel2: disgarrisoning
sawyerm2: lapstreaks
sayanic: punto
sbeckwit: outlives
scapicchiod: bush
schafern: microloan
schafers: gutturalism
schallyn: toddies
scheiderd: planched
schifferc: graplements
schillingm: romancer
schillj: patriclinic
schmidtj3: beachgoers
schniedersb: corruptionist
schondorfa: unadvisableness
schregardusc: popsies
schroffj: barrow
schudah: repudiations
schuelkek: pleuritises
schulenberge: presternums
schultzm: renitencies
schurs: squabbed
schustero: clubmen
schwartzb: epilogistic
schwarzerw: abominators
scottm3: ferbam
sebestab: unpennied
seefeldta: salient
seleym: corruptibility
sethl: enfire
sewellk: anatomy
seymourc: leukocytic
shaha2: clutchy
shahe: consorts
shahidm: phosphatise
shanaas: pipings
shanson: hydrochores
shaoe: durns
shapirob2: rechoreographed
shapiroj2: frilling
shapirol: dilatant
sharmas: predestination
sheltoni: intestacies
shenholma: ismatical
sheny2: mixers
shererj: supercolossal
sherrickb: publishable
sherrickj: blintze
shibuik: interjector
shim: pyrotechnically
shiny: sanguines
shirleyj: busting
shiy: tonging
shoree: shabbier
shreerom: muddleheadedly
shucka: prewarming
shufrozletzj: boongs
shugartc: assistantship
shumwaya: riva
siddiquia: cheerishness
silvam2: beachgoers
simonsi: salaciously
singletonj: toc
sirothphiphats: trochosphere
sirulnikb: fleshiness
sivulat: homeport
sixs2: strongbox
sjandro: flannens
skennedy: turbulencies
slaytonc: guacamole
sleonhar: oxtongue
sloom: trodden
slopez: scuzzier
smallj: caraganas
smallj2: netops
smeerts: saintisms
smeyer: bachelor
smitha5: cornopean
smithc4: unbuckled
smithc5: mumps
smithc6: stolen
smitherbm: particleboard
smithj5: freewheel
smithj6: dunt
smithm5: manifestations
smithm6: ering
smitho: etrangere
smohring: engrainers
snarayan: dilapidation
snidmanl: tinklings
sochackim: exheredated
soehnlinn: numeration
solimanh: scumming
sollj2: sparsedly
solomonf: domineeringness
songy: mosbolletjie
songy2: kinematography
sottrelh: flavorings
soufanm: drooliest
sparksp2: ramming
spatters: heteronymous
speakesd: swigs
spencere2: beltways
speranzellaj: hyperpnea
srivichainunn: telesoftware
sschoenb: becowarding
ssippy: slags
stacke: dabbas
stadelmane: invariancies
staffa: disponge
stahla: cognoscenti
stametsf: twiningly
stametsm: lemniscal
starlackr: outpopulating
stateno: hypermanic
stecklowm: nonadiabatic
steinbergk: haftorot
steinera2: abeyance
steinkes: theatromania
steinl: boys
steinl2: giantship
steinr2: presterilizing
stemd: gurjun
stepanskiw: oysterers
sternsc: photogram
stieglerr: novenaries
stoughtonk: abayas
stoutlandi: unvarying
strandn: proctorise
strathmana: jatakas
stritzelm: capriole
stroebell: concause
stubbsa: eaglestones
subramanianr: simpler
sudderthm: wonderkid
sullivank: frangibilities
sullivanl: reclaimed
sullivanr: nozzers
sunk: ditchwaters
sunn2: astrofell
surdutovicho: washaterias
sutcliffea2: naifer
suy: urinose
swaffordx: weepily
swarups: enwombing
sweeneyk2: winns
syoon: fustilirians
szafranj: photoinduced
szafrano: draffish
tae: releve
taftw: topos
takamorim: respeaking
tamert: heteroploids
tamj: improvidences
tanakar: instaurators
tankersleyc: originated
tanm3: satrap
tarasd: downlight
tardio: etiquette
tartagliaa: throppling
tashjiana: gied
taskintunak: absinthism
taylork2: cockles
tbarkmei: reman
teetert: presentnesses
teferar: stomodaeums
tennentr: lysogenizes
terwilligers: garcinias
tessieri: irradiator
thandis2: mistermed
thantm: peising
thelenl: argentiferous
thengl: cebid
thillm: gardening
thomastotha: sloops
thomleye: lycopenes
thompsond: twosomes
thompsonw: nas
thulsont: ciboria
thurmana: cypreses
thurowm: haemostasias
tianh: obese
tianz: ratton
tierneyf: dishables
tietyeng: prothonotariats
tieut: lattens
tieut2: cullion
tillinghastn: fugging
tinea: overinvestment
tionga: turbeths
tisdalej: tinderboxes
tisserandm: hollowares
tlittle: lazies
tmadsen: preppiness
tmyint: phenylenes
tnega: squirarchies
tomj: prao
tomlinsonk: phosphine
tongh: centrums
topels: interlaminates
torstensonl: glockenspiel
towneb: bookworks
tpittman: cargoes
trank2: swoun
tranm2: seawife
trawalleym: grampas
traylor: amperage
truebenbachc: calendarisation
tsuic: pi
tun: clackdish
turnerk: phonographies
tut: flabs
tydingsc: solos
uchitelj: lickerishnesses
uedah2: trainee
uribec: oviductal
uttleyh: broomball
uyedah: grailes
valem2: canonically
valtierrezf: babblings
vancea: hansardise
vandele: revibrate
vanderwerkerm: strategizing
varelaa: blench
varmaa: nonleguminous
vazquezn: aking
vcoleman: textphone
vegas: aper
velascom: sorry
velasquezc: pyrogenicity
venetise: hypochondrium
veraleyvas: vowelizations
vidalg: butles
villagomeze: brogueish
villanuevaj: vertu
villarrealv: rentable
viswanathana: flypitcher
vithoontienl: simoniac
votawh: skirl
vozzar: dongolas
wahlj2: hamshackled
walkera3: aureities
walkerb2: packsaddle
walshm3: pyritical
walshw: mane
waltersa2: adversariness
walutesj: hexachlorethane
wanga3: anorectics
wanga4: bready
wangc4: oedometer
wangd5: toquets
wangh3: thrae
wangj6: cartologies
wangk2: saltest
wangm2: wait
wangs6: chronaxie
wangw3: superwife
wangy3: outgalloped
wangy4: rellenos
wangz: nannygai
warners2: peckier
wasende: stoner
washburna: refluence
washingtonj: noll
washingtono: actinozoan
watowichm: grandiloquently
watsone2: batman
wattsa2: decreases
webbj2: freety
webbl2: yonnie
webbn: dovecot
websterc: microtone
weedens: flimp
wegea: laminous
weges: espanoles
weid: disconcerts
weie: beardiest
weil: pyritical
welchp: wherrits
wenc: reasonabilities
westerr: constructivists
westj: goldfishes
wetzelr: linguistic
whitec2: glueynesses
whited: kalends
whitedavisj: subitized
whiteg: mimmicked
whitej2: malmags
whitej3: invariables
whitel3: tatting
whitet2: peacoats
whitfielda: handlangers
whitisa: theologizers
whytem: vomeronasal
wilcoxt: dimidiate
wilderr: irascible
wilkinsonm2: disorganisation
williamsa: baconer
williamsc: zizel
williamse2: galenical
williamsj3: entrances
williamsj4: heatednesses
williamsn: kithe
williamsonw: woodpigeon
willickd: sackings
willmorej: shriven
wilmots2: shending
wilsong2: satcheled
wilsonk2: sultanesses
windleyb: multiflash
winicks: neoteinias
winstonl2: vertiginousness
wirthm: sulphadiazines
witneyj: sinopias
wittej: powin
wnorth: encore
wojtowiczi: swelting
woleskyp: gabelle
wolfet: stocktakes
wolffkinga: caracolled
wolfflandauh: interchannel
wongrattanapibos: tombs
wonnellr: depauperized
woodruffe: pekes
woodruffn: historiology
woodsj2: prones
woollenb: charango
wormanm: sera
worrellm: shortheads
wrighta2: epignathous
wrighte2: obeisms
wrighte3: whemmles
wrigleye: quizzifying
wuj2: acrobatic
wuk2: terebrating
wur2: debiting
wus3: hyperpure
wuy3: reexpel
xaviert: haes
xiangx: trominoes
xiel: vaticinate
xiongk: anchorman
xiongl: penumbra
xiongx2: splinters
xues: rareness
yagero: batavia
yamadad: mediateness
yamadaj: pothecary
yambingj: riverheads
yanaij: sophomoric
yangb: depends
yange2: waide
yangm3: projectment
yangy2: sententia
yangz2: yellowcakes
yanj: nucleosomes
yankwittr: tiddly
yanr: superhets
yaxn: hydration
yazdanpanahp: thuggisms
ybenami: subsidisable
yeec: mikvos
yel: zoographical
yeracarist: justly
yime2: pyramidology
yimf: asperous
yis: baggit
yklein: synarchies
yorkd: escalatory
yoshidah: abiotrophies
younga3: stationariness
youngg2: vitrics
younkinsa: debilitative
yuana: gadget
yuez: unnaturalise
yugovl: sapsago
yuk2: heptathlons
yus2: geognostical
zacharskim: bonamias
zappam: supportively
zeilingera: prenatal
zengd: eunuchizing
zengt: smartening
zerrs: sacrilege
zhaidar: workhours
zhaiw: interplaying
zhanga2: odontolite
zhanga3: ephorates
zhangc: rachiotomies
zhangc3: multiloculate
zhangd3: lobber
zhangf: nephroscopies
zhangh: locksmithing
zhangj4: stigmatized
zhangj8: sums
zhangj9: jaculated
zhangm3: passionately
zhangs: geropigas
zhangw: pentacrinoids
zhangx2: wakener
zhangyangj: arrogant
zhaos3: retro
zhenga3: verstes
zhenga4: misimpressions
zhongj2: unsheltered
zhour: samitis
zhue: ironmongers
zhuy: hallucinogenic
ziemsr: siri
zouy: nithering
zucka: supererogators
zuczekx: lackering
zunigao: tipsier
zweifelc: radiesthetic
rhea: polypidoms
bareos: sensitivity
jryan: calamity
adamsc3: unclutched
allenj2: redargue
alstonj: rickets
arche: communization
aroraa: caviars
babcockc: greeted
bagerekap: unshackled
balvuenaa: creston
bassekleg: cretinized
bassp2: marketizations
batsaikhanb: plebbier
bells2: scarph
bells3: molehill
berryn: overpraise
bestb: paraphiliacs
blackmonjimenezd: appurtenants
blairs: daylighted
boettigerl: vaws
boileaus: autographing
borlaka: sleevers
boylee2: mastoid
brachoa: seined
bradies: excrement
breyerr: flub
bronstonea: gildhall
busht2: caraculs
carlsone3: scowrer
champlisst: sheerlegs
christensene: avert
clevelandj: spink
collinsm2: wry
conleya2: beshamed
corboo: cottoning
cuttera: musketoon
dannal: uncases
davidm2: storiologies
davish: skimboarder
dongz: polyhydric
ehrlichmanc: renunciates
fernandesj: elegiac
fischere3: vindemiates
forsythm: reticently
fostert2: overthinks
gallina3: autogyro
garcial2: synopsising
ghaneabassirik: wealsman
gunnarssonm: mares
hicksr: tamises
hirshmane: bushmeats
hogansona: negotiabilities
hussemans: winter
jenksg: hangmen
jensenm2: chinbones
johnsonk4: brouzes
jolson: linkage
kadams: recriminations
ketemah: unadapted
kitamuraa: hylozoisms
klinem2: bayberries
konga: unlikeable
lentzo: anticks
leonettia: sogdolager
leveyswaine: boused
lewisr2: seiche
lionf: salol
mateosk: lownd
matha: scrounger
mccartys: escrol
mcgeheej: faugh
millerr2: secpar
moralese: tide
moroccoe: contriturated
omarac: necrophobia
patinon: fortepianists
peerzadac: ruddles
petropoulosa: nonobservant
renb: mushiest
reyesrojasc: semiterete
rohdem2: gurus
schaefern: hypernym
selkowitzj: palaeographists
shiferawh: subeconomic
siuo: bavins
smarta: quiddle
stockwella: stellated
tasb: behemoth
thaon3: reindeers
tordib: dizzard
townsendl: lieutenants
tyreek: phratries
vonga: ascend
vostinar: nasopharyngeal
wangs7: ascensions
weinsteinc: ycled
westawkerl: raca
wilsond3: trichogynic
yumk: pinealectomies
zemanj: overglamorise
zimmermane: turpentined
ashe: fanaticizing
bartelsj: prizefighting
blanchardm: formalise
friedmant: epiloguing
galambosa: rosining
gonzaleza: mycetologies
haasl: sculs
hansong2: floribundas
hansonj3: gluepots
hashimotok: phagocytises
helmboldk: hudnas
hooperk: calumniators
ismaily: gallnut
kampa: eucaryons
kennedyl: cozed
kharea: miseases
khesinm: coccoidal
khouwa: spirlings
kims3: correligionists
leegilligana: stumm
lesurea2: journalistic
lewisd3: separatrix
lians: trephine
lib2: dyvour
liny2: finickings
liuc4: upload
lordk: border
lundbergh: danelaws
lus2: sumptuosity
marksb2: telecameras
maruyamak: cabernet
mazura: edaciousness
melvillec: briniest
mensahj: sensile
millera3: beelike
morduchl: hilloed
morrisa4: bruckle
nachtm2: moten
nairs: gammatia
nguyens3: gormandiser
parkj3: vias
petersonk: shown
polydorouc: fluoxetine
ramazania: habitat
rapoports: conundrums
ristinoa: downfield
rogerse2: revegetations
roskopfe: gouging
roslanskyc: chibouques
sainiv: orthohydrogens
scotti2: shmoes
shannoh: placate
shusterl: thermidors
smithm7: betrays
suhd: reflectorized
thompsond3: warehousers
tiltonm: allay
trann: reseaux
tranr: modalistic
tumaa: enveigle
vipparlaa: memes
williamsa2: valpolicella
wolft: escorting
wuj5: recodification
xiongk2: logarithm
yangm4: strutter
youngk2: burbot
youngr2: speedos
zhangx3: parklike
zhua3: copperworm
banksa: typhlitises
carragherj: sclerae
cokera: expressly
donovanm: politicasters
dyermokg: gaydar
fabera: parapineal
feldbergm: ruffins
floquetl: mistitling
kartheisere: rationalistic
kimd: woodbine
kombatem: filtering
kunzmank: whaikoreros
lorda: glisk
mcadamsg: sculpt
moorej2: scutter
pilled: volet
randal: amelias
seths: skepsis
sheffieldf: serotine
sivulaa: leges
siyakurimam: triphone
solakhavam: takingnesses
steelb: amirs
vermam: steamtight
weismannh: gummosity
widmana: polo
wintert2: ballanted
zhangy4: slivovices
lipinskic: botheration
shayam: shooras
taylorc2: chivvying
williamsc3: highchair
wyffelsm: engoring
moyerj2: obstructiveness
oddene: evos
agarver: plimsoles
alejandroe: fatless
alveys: nieces
antrimr: magnesic
antrims: stiltednesses
bakkej: keystoning
barfieldt: yaw
bicej: recladded
boskovica: plethysmogram
bozicevicht: disciplined
brennano: prepuces
cadaramc: upsizing
caia: tridominia
careym2: alchymies
causeyj: seminomata
chena5: foisted
cunninghame: aviaries
dauriac: krauts
davidsons: rationalist
delgados: wany
delnegron: oxgangs
dimondc: engraining
djerfp: midinette
dongh: asset
dorchens: edutainments
dowlinge2: sweatiness
dushimea: baguet
eiferta: minidish
falka: cetyl
floresc2: shlub
geistk: stewpan
gelosf: misliving
georgep: retrorocket
gravesm: overbearingness
guerrerov: breadbaskets
hannak: endoplastic
hempels: morphinisms
hlavacekz: reliever
huangc2: rehospitalises
huffmanj: bloomless
jaffars: centage
jeffersonk: timeservers
johnsonl3: arterializes
johnsonlacosss: carburetors
jonese3: assais
katariay: eminency
keiltyf: goblet
kellyr2: pallets
knopk: carnal
kojimam: overpackages
kondas: cicutas
kortaneke: riverway
laytonm2: reaedifyed
liur5: gonorrhea
lwinh: ophiolite
marvinc2: metamorphism
mayoralg: eukaryons
merchantc: photoreception
mirzaw: shortly
mooren2: stutterings
moriyamaa: tuggingly
nguyent4: dancettee
nicholsonj: abducentes
pattisona: relentlessness
phamd: herbologies
pinac: katti
piusa: thimblerigging
przybylan: immurements
rahmans: frowsier
raiu: preprogramming
ramirezs: googolplex
renem: amphipod
richardsonb: liquored
rizzoj: repasting
salijk: reappraisers
sallingerp: crying
scoolerh: keelhauling
scotte2: crankles
shabaitah: clasts
shahs2: denuclearising
shalitak: oophorectomise
slovesb: coccidium
smithk4: hypothesis
smithr4: redetermining
spaine2: sahib
spezian: gorges
stephensm: subarrhations
storliee: perissodactyl
subramaniana2: kabaddi
tetie: cacodemon
tinajeroa: engrossedly
tranb: boyish
tullioo: scolecites
uttleyg: worldlinesses
valdiviam: avaunted
vanders: endangered
vazquezm: silenus
waltherp: nonwoven
wangk3: scagliolas
wardp: uncanninesses
williamsc4: lairing
williamsj5: wynds
yanga2: insufficiencies
yazdim: xylobalsamum
yeomj: microcephalous
zewdum: shebang
zhangt: monoplegic
zhoutan: inching
anyiwee: halfway
appelj: revengeful
baggetts: melicotton
bailona: lusterless
beretsl: pacemaking
bonnellz: socketed
brandlc: fiberizing
cantrelll: satisfiers
chamberlainb: unlovingly
change: scriptural
charlies: pazazz
chownt: submolecules
dejarlaisd: tead
edmondsh: proctored
eliasj: unwishful
elliottc2: pethidine
engermank: clergymen
fongj: confirmable
frankelh: bahuvrihi
freedmane: hokku
fridkina: niteries
garbym: provokers
goodmand: boardmen
gorordoa: caries
hollebp: faithlessly
ihlenfes: furfur
isaacmans: tantalizers
jacobso: gimmals
jonesa2: ultrastructure
kachmand: disenslaving
lees6: undiscussed
legbaf: jackal
lic4: variegators
mones: cannabis
muellern: micrography
parrm: billfolds
reinholde: previable
rubeyp: comms
schlicke: bupivacaine
tellea: li
wiggint: indicative
wongc2: cleche
abougabals: extincted
andersoni2: eths
awadm: leaderless
bistrupi: gemman
dema: dunging
edstroms2: brannigan
farmerk2: oratress
forstere: deciliters
frieds: misdeemed
gibbensa: admired
gilberts2: rheumatology
grieselb: koeksister
grossmanj2: homesteaded
iyengunmwenae: prenubile
jiab: couscous
konshiel: flauta
lenniea: auspices
lonea: racehorse
meekerd: subscribe
moreb: candlesnuffer
naw: walkways
owensj2: laterals
rhodess2: nonemergencies
singerg: shalwars
thomasa2: bankcards
wataokac: gobioid
westone: odours
abdallan: sememic
ahmedt: homemade
aladetana: sociopaths
aldaghlasn: scrutineers
alexandera: moderatrixes
armstrongk: roughleg
arnowb: clickless
baigt: miniments
bettnerb: euryhaline
bettnerj: scazontics
blaneym: yeading
bosmann: underleasing
boulism: cenotaphic
bravop: ultroneous
brewsterw: tympanics
buchalh: anemone
burnsider: clubbings
chowdhuryt: sanga
crossh: gladwraps
davanzoe: pettifoggery
dennehys: leproseries
ellisn: saicks
escutiam: gyrovagues
etelsonl: shrowd
frostb: ecclesiasticism
garciaa: dispirits
glaserz: microgram
glovera: disheartening
gulledges: squiffy
haddockc: pictogram
honga2: hierogrammates
hoppera: gallanting
hoytniemieci: promoted
jamesona: deadbeat
jonest3: precedents
klinknert: sarnie
krollc: mangelwurzel
lattaln: utilidors
lazob: cholents
leduce: laverocked
lees7: convulsionary
levineb: smuttier
linderd2: stents
lunae: reverential
maags: phrasemongering
mcphersonn: vavasory
mittonfrya: bowpot
mustilloe: toxiphagous
neidc: demonologic
nevillek: paramagnetism
normana: glyptal
obora: unpin
overbyj: officialdom
pattersonc: panpsychist
pottero: tschernosems
ramekeri: implodents
reedc: auriculas
riessb: prokaryotes
rosethc: flexible
satherz: downloading
schultzc2: drowsy
shapiros2: achondroplasia
shenm3: adenoidal
sheridans: coches
silvaj2: swordplayers
smithd3: wise
sscheirer: beglamour
stovallm: bribees
strikem: bagnio
tehranin: cite
timminse: plunderable
turnerb2: covertly
wangs9: corniced
watsone3: awarned
wellera: undertakers
wilsona5: swerfs
xiay: blisteriest
xug: rumping
yipk: biopsies
youngbloodl: cylindricality
zhub: badnesses
lik: conductiometric
acerom: triumvir
arnoldp: outmuscles
aronsonj2: monosymmetry
assalip: surtitle
baeckn: plumpish
banfieldb: myriapodan
banovetzm: molecast
barbere: minds
barhama: inseparableness
barryhan: metasoma
baxn: grooveless
beemanweberm: technos
bhogarajus: unsnarl
biny: lacerability
blacka2: enables
boeror: continuous
bombeik: immovableness
bordenm2: leveller
bregouc: ditas
brownp2: erythematous
cabaacevedof: sneakishly
caok: dalmatics
caoy2: fiddlier
carlsont3: tackies
caser: grouped
casperd2: wordbreak
chisholma: sekts
choij: erotical
cichowskil: mentorings
claussa: stargaze
cohena3: ditch
crewsa2: microchip
dbastola: nonguilt
detmerh: precompetitive
drapers2: nuffins
drummondj: malevolences
duanc: disulphates
eae: outdistanced
ederingtons: tanrec
endoi: hebetative
fairk: ectoprocts
fellandm: canceler
flodine: abusivenesses
flowersr: interbehaviors
frischm: flehmened
gebreegziabhery: goodwilled
gordong: rabannas
grandem: backbond
grayt2: unwifelier
gunadim: tilefish
guw: eutectic
guzmanm: ballicatter
gwina: refixes
halla2: falchion
hawadlea: furfuran
heynesk: salvifically
hinrichsr: prewriting
hoenem: phospholipases
hommeyerj: loutishness
hosem: invaginates
hultmanl: ballasted
humese: majlises
ishikawas: grittest
izabayop: scribble
jahne: falsifying
jamesc3: derivatise
jettya: condole
jingg: paradisean
johnsone2: etas
johnsonm3: maligner
jonesb2: preassure
kangt: polonies
kaplang: rantings
keanel: punchboards
kellerm2: vociferated
khana2: acutenesses
khana3: harpers
kleinhansc: handplays
knappc: larruped
krajcc: mucronation
kuangj: catfall
laffertyn: rejuggles
lanegraffe: jettisoning
lanzilloj: foretime
lauere: travestied
lazog: relive
lecuyerj: verslibrists
lefeversb: pheneticists
lelea2: prostomial
leonarda2: lonicera
lin: untenably
lintone: couponings
luongh: labiality
luongn2: monocycles
lyuk: thinginess
machaleck: philologue
macleodh: pristanes
macveaghc: batteled
mandalas: saucepot
marasht: unsoured
maringc: menses
marquisz: karakas
matthesg: ethylbenzene
maxwellc2: sinewiness
mcdermottm: attracting
mitalskim: rhubarbed
mohamedi2: tipcat
moranh: catfishes
morelandb: turnkeys
mortenseni: uncrosses
muraharin: crystalisable
myerd: bucksom
neiroukhm: aldoximes
neithartb: postforms
nelsong2: encyst
neyc: annunciate
nguyend2: remarriage
nguyenj3: nonsequential
nit: emblazonries
nortona2: rufescent
onwumerea: isosporous
orensteint: gawkers
ortiza2: stoicheiometry
patels4: unbeginning
patinoj: verifiabilities
phillipsw2: dervish
piccirilloj: bikeway
qina: overwatered
quanbecks: xiphoid
quinns: seminudities
rajad: bollix
rapaczs2: feliciter
reeshille: prenatals
rheeb: rundales
ricea2: kakapo
rileyi: degassing
riveraf: recompressing
robertsr2: disunionist
rodriguezd: misnaming
rojanasoonthont: equinely
rosez: eocene
russellb2: northings
salomonl: amberina
sebertf: dehort
serranon: disbursals
shresthaw: lazzo
somaa: invulnerably
songj2: lowlighted
sternh2: creditors
stojanovicm: cavillation
stolberga: osteal
swansonl2: overcultivation
szetob: killies
taa: campimetries
tanakas: contemnibly
tananbauma: dragonfly
tannirae: answer
tany2: ruggedizes
tchouaffem: nuance
thornea: fehme
toledod: refocusses
tourea: feudatory
trant2: subtilizer
trawt: tamponades
tune2: lukewarmish
vangsteins: abashment
viegaseguiaa: decontamination
vilmsj: counterblasts
vinyarda: solans
wangm5: antilibertarian
wangn4: rhyne
wangw4: retailed
weinerk: spectra
weldont2: symptomatic
wengs: homotaxial
whartonl: navar
wienerc: bootlicker
willsr: recreated
winhallk: dippy
wolffm: ambisexuals
xiaol: wristbands
yangb2: defeudalise
yoony: obligers
yuane: bowings
zackss: starred
zhaob: whicker
zhaoh2: sequencer
zhuh: chartography
thurstond: ratcheted
bakerstahll: santo
blagburnd: gyny
chetitac: tensiometry
cramptonc: symposium
dengs2: demarcated
dunnr: foredoes
emekar: gallantly
hozm: barbet
jinga: oliphants
jonesz2: rankers
kellerb2: trophallaxes
lengx: corporealities
merchantj: technophobics
moranl2: misdirection
mrood: enkindle
sajwanis: zygocactus
schubertr: gutterbloods
srinivasans: photorealisms
tuttt: demes
williamsn2: pupation
winj: respirometric
zerwasb: unhairer
abbasharm: erlang
agboolar: canting
akeelh: brims
akyianun: shahdom
anyaegbunamu: matroyshkas
appelbaumj: buzzcuts
arzayusl: forereaches
badjouendzouabea: dietetics
bakerc2: vorago
batesh: conquest
bergenee: skillcentres
bessore: persona
birkk: widowman
boydl3: phantasime
bradjanv: tragelaphine
brattonb: tardies
buhmanq: ixtle
cabanelak: philomela
caldwellm: hammertoe
capeilleresh: formalizable
carteri2: poundcakes
chend2: misword
cherkashinaa: sforzandos
clinecolee: interinvolving
commonsj: symbolisation
crimmeln: aasvogel
deferm: impala
deharpporteh: floorheads
dellefaves: misallotment
dianas: verberate
dippoldc: prostantheras
drakel2: chromakeys
eidelhochm: pasture
eldridgec: gampish
ezemosakwea: modii
fischere2: scrimpy
friedmanl2: medicinal
garciam3: plumbous
geletar: movieolas
gevurtzs: bashings
glaubitzs: immarginate
greenleea: catechisation
guilloryt: tendons
gulatia: ungirt
hamlino: bloodcurdlingly
heine: mudrocks
henryi: outgained
heywoodl: surmount
hiranok: drying
hollowaya2: saltoing
hovingg: vandalising
howardm2: impersonalised
hudsons2: escalopes
jablem: sinuslike
jasmerj: volitational
johnsona6: peroxy
kellyp2: zootrophies
kimbels: fierier
kindallv: justle
kingmal: javelining
kirtnert: dekametre
kischnera: recycle
kleinh2: outboxing
lautenbachw: simurg
lengyels: unlining
lesneskia: resided
lewism2: blankings
libergef: autoplasty
linj4: nonpagans
lozoyaa: dendriform
masaddee: agronomies
mcwilliamsc: enderon
meierj: squabbles
mooreb: teaselers
moralesk: ritualistic
mosesh: kolo
moshfeghih: biogenetically
nguyenq3: undermentioned
nwikeb: thawing
ochoaj: halal
olsonk2: arachnologist
osbornt: concomitancy
pareth: hippophagists
parkersone: mammifers
pengd: redeployment
penna: corroborees
petrinih: machzors
prevesc: underlinen
princeg2: bandars
puzellaw: pleuchs
quadea: photojournalist
qux: innovationist
ramans: unnail
roesslera: tomcat
santamariar: dipterocarp
santamarias: crustacea
santosr: rolfing
sarnos: punners
shent: diffracts
shteymanm: megatonnages
smiths2: overexerts
stierh: santon
tefub: premoved
thomastothe: multibladed
ursina: pintle
vanderc: gratillity
wardh2: syncretism
wonacottr: animal
wyckoffs: quartetto
yushkoa: waggonettes
zhangc4: semihoboes
zhange: synonymatic
zhangs4: orarians
ansara: workingman
baldoj: pilgrimising
bengtsone: ruching
chackerians: sneeringly
collinse: counterpoises
contrerasb: nonparity
danielskoche: puddening
dhugumak: eastling
flanagano: interclub
forsterb: unannoyed
haddady: zymology
hallmany: midges
leec3: buboed
liskot: disaffectedness
oishik: allodium
paulyg: juxtapositional
peralesa: ungilds
perfettos: misbutton
qureshik: oxyacetylenes
reyese: incloser
riersond: pacificated
rosea: craterlets
shiffmanm: wallah
snowbecke: nonmobile
songc2: laced
storke: nonevent
thomask2: micropolis
troopw: shriveling
wange3: gruffly
youngrenk: intimidatory
meyerb: palaeography
ntp: moschatel
abebayehub: appraisal
asfawa: erythron
bacong: pricelessly
bansea: ratan
bartelj: unirradiated
bauern: salivator
beckerr3: hagiographic
brownc3: hydrocelluloses
buddie: vicaries
buonopanee: flapdoodles
burtonk: padrones
butlere2: almucantar
bynumg: relieved
cardenasl: galenites
changstuckiw: convokes
chans: merchandize
chasnovm: odiously
chatardl: nonconductor
choderat: passades
choom: retranslations
choud2: presidentships
coganp2: eunuchoid
cooka2: titulus
coyleh: clitorectomy
dakaw: yappies
dhungels: encapsulates
diass: attenders
dicarlos: malteds
dirkswagers: virginium
docterloebj: punctos
duffyk: gilded
dvergstenc: aberdevine
euaanantp: compurgators
fernandezm: phalangids
foreros: culinarians
foxarnoldd: quelea
frankela: enmities
fraziera: fertilest
fredericksa: lithomarge
gangulya: redaction
gaoe: archangelic
gerardc2: attenuates
goetzs2: bitchfests
goldmanc: mindedness
gregoryj: inhumes
harrisl2: monovalences
hintons: ethyls
holmesc2: twinters
ingrame: gyrofrequencies
iyera: eryngo
jenseng: gay
johnsone3: cerographs
jordanl2: melismatic
josephn: worst
kellyw3: distrixes
konidenap: afflicts
kuh: ecoterrorism
laceyi: wus
lakeh: windroses
langreen: coleopterous
leed3: nach
leeh3: bioregions
lehra: disfunction
leona2: taluka
loxe: eudemonist
luk2: surveillants
macdonaldj: cosponsoring
mallika: centrode
mccaffreyl: unfamiliarly
mckinleys: nightjar
mcmanuss: coenestheses
mehtaa: rowdier
melomejiac: flagitation
merrells: peytrals
moonblackj: panegyrica
morrisn: zhomos
nagpalj: purtraid
nechiporukm: michings
obonon: veilleuse
onabolub: ontogenetically
orjalae: uncharnelling
ortegaj: nineteenthly
parkj4: hoochies
paulsoni2: fehmic
peoplese: divaricately
phinneya: pteridologist
poreddyn: unaddressed
qil: grevilleas
rankinm: lycee
rasts: nightmare
richardsc: precancerous
rothmana: parras
rykhusm: coronoid
sasserd: legionellae
serotam: dorhawk
shafers: flaggy
shoveb: southeasterly
shuffeltonj: toolholder
sinhaa2: radiopagers
sinnerp: tappa
starkb: toothless
swansonm2: disavower
tangumaj: leno
tilleyr: equivalve
tilsonk: rotter
trank3: forkers
ulicnys: phoney
uyekif: misgrows
vadnaiss: gonfaloniers
vaganovv: delighting
vanormani: tapsalteerie
vargol: sillinesses
vazquezi: engaging
vosena: imbroglio
votrubam: soundcards
walkerj2: thematisations
wernerg: hindshank
wiegmane: portion
yangw2: peroxidizing
yaps: bevvies
zhangs3: champing
zivsaka: unserviceable
mcclaina: smashing
